4,000 years in the future. There have been electrical disturbances of varying severities across El Tellaga Tyne for the past few months. You put your foot down and decide to do something about that.

LOMIRA
An Interactive Fiction by kroberts21
Release 1 / Serial number 190424 / Inform 7 build 6M62 (I6/v6.33 lib 6/12N) SD

HOME
Your home is on the outskirts of the city. A really old, cramped apartment that's falling apart. Everything is falling apart, from the floor, to the sink, to the bed, everything. There is a jalousie window on the back wall. Its panes look clean. A single faded yellow lightbulb illuminates the whole room.

You can see Backpack (closed) here.

I beg your pardon?

I beg your pardon?

* * *

I beg your pardon?

>n
City Entrance
You can see Molecular Splitter (empty) here.

>put coin in molecular splitter
You put coin into Molecular Splitter.

* * *

>n
City Entrance
You can see Molecular Splitter (empty) here.

>put coin in splitter
breathe yes haha

>i
You are carrying:
  oxygen tank
  key
  coin

* * *

>e
Shop

>w
HOME

>w
Well

>e
HOME

>n
City Entrance

* * *

>get naked
You can't see any such thing.

* * *

>i
You are carrying:
  key

>open backpack
You open Backpack, revealing Metal Bar, Knife, Canvas Sheet, Rope, space suit and helmet.

* * *

>i
You are carrying:
  key

>s
Badlands

>s
Cave Wall
You can see trapdoor here.

>down
(first opening trapdoor)
It seems to be locked.

>unlock trapdoor
(with key)
You unlock trapdoor.

>down
(first opening trapdoor)

Generator
You can see trapdoor here.

>s
You can't go that way.

>down
The Core

>up
Generator
You can see trapdoor here.

>up
Cave Wall
You can see trapdoor here.

>close trapdoor
You close trapdoor.

>lock trapdoor
(with key)
You lock trapdoor.

* * *

>n
City Entrance
At the mouth of the cave, there's a heavy, bustling steampunk atmosphere, densely populated by humans and cyborgs. There are clotheslines which stretch from building to building and wide, rusty metal pipes that clunkily wind around the walls. Embedded in a wall on the side of a road is a molecular splitter, where one can buy an oxygen tank. Leaning on the wall a few feet away from it stands a tall, flamboyant man.

You can see a Walker, Molecular Splitter (empty) and a coin here.

>i
You are carrying:
  key
  coin

>put key in molecular splitter
breathe yes haha

>i
You are carrying:
  oxygen tank
  key
  coin

>s
HOME
You can see Backpack (closed) here.

* * *

>n
City Entrance
At the mouth of the cave, there's a heavy, bustling steampunk atmosphere, densely populated by humans and cyborgs. There are clotheslines which stretch from building to building and wide, rusty metal pipes that clunkily wind around the walls. Embedded in a wall on the side of a road is a molecular splitter, where one can buy an oxygen tank. Leaning on the wall a few feet away from it stands a tall, flamboyant man.

You can see a Walker, Molecular Splitter (empty) and a coin here.

>n
SURFACE

    *** You can't breathe ***

Would you like to RESTART, RESTORE a saved game, QUIT or UNDO the last command?

* * *

>n
City Entrance
At the mouth of the cave, there's a heavy, bustling steampunk atmosphere, densely populated by humans and cyborgs. There are clotheslines which stretch from building to building and wide, rusty metal pipes that clunkily wind around the walls. Embedded in a wall on the side of a road is a molecular splitter, where one can buy an oxygen tank. Leaning on the wall a few feet away from it stands a tall, flamboyant man.

You can see a Walker, Molecular Splitter (empty) and a coin here.

>put coin in Molecular Splitter
You put coin into Molecular Splitter.

>i
You are carrying:
  xOxygen Tank
  key

* * *

>n
City Entrance
At the mouth of the cave, there's a heavy, bustling steampunk atmosphere, densely populated by humans and cyborgs. There are clotheslines which stretch from building to building and wide, rusty metal pipes that clunkily wind around the walls. Embedded in a wall on the side of a road is a molecular splitter, where one can buy an oxygen tank. Leaning on the wall a few feet away from it stands a tall, flamboyant man.

You can see a Walker, Molecular Splitter (empty) and a coin here.

>put coin in molecular splitter
breathe yes haha

>i
You are carrying:
  oxygen tank
  key
  coin

>i
You are carrying:
  oxygen tank
  key

breathe yes haha

* * *

>n
City Entrance
At the mouth of the cave, there's a heavy, bustling steampunk atmosphere, densely populated by humans and cyborgs. There are clotheslines which stretch from building to building and wide, rusty metal pipes that clunkily wind around the walls. Embedded in a wall on the side of a road is a molecular splitter, where one can buy an oxygen tank. Leaning on the wall a few feet away from it stands a tall, flamboyant man.

You can see a Walker, Molecular Splitter (empty) and a coin here.

>put coin in splitter
breathe yes haha

>i
You are carrying:
  oxygen tank
  key

>s
HOME
You can see Backpack (closed) here.

>w
Well
You can see a bucket (empty), Lever and Button here.

>i
You are carrying:
  oxygen tank
  key

>put key in bucket
This isn't a valid piece of currency. Try putting in the coin.

* * *

>put coin in splitter
breathe yes haha

>s
HOME
You can see Backpack (closed) here.

breathe yes haha

* * *

>n
City Entrance
At the mouth of the cave, there's a heavy, bustling steampunk atmosphere, densely populated by humans and cyborgs. There are clotheslines which stretch from building to building and wide, rusty metal pipes that clunkily wind around the walls. Embedded in a wall on the side of a road is a molecular splitter, where one can buy an oxygen tank. Leaning on the wall a few feet away from it stands a tall, flamboyant man.

You can see a Walker, Molecular Splitter (empty) and a coin here.

>put key in molecular splitter
That isn't a valid piece of currency. Try putting in the coin.

>i
You are carrying:
  key
  coin

>put coin in splitter
That isn't a valid piece of currency. Try putting in the coin.

* * *

>n
City Entrance
At the mouth of the cave, there's a heavy, bustling steampunk atmosphere, densely populated by humans and cyborgs. There are clotheslines which stretch from building to building and wide, rusty metal pipes that clunkily wind around the walls. Embedded in a wall on the side of a road is a molecular splitter, where one can buy an oxygen tank. Leaning on the wall a few feet away from it stands a tall, flamboyant man.

You can see a Walker, Molecular Splitter (empty) and a coin here.

>s
HOME
Your home is on the outskirts of the city. A really old, cramped apartment that's falling apart. Everything is falling apart, from the floor, to the sink, to the bed, everything. There is a jalousie window on the back wall. Its panes look clean. A single faded yellow lightbulb illuminates the whole room.

You can see Backpack (closed) here.

>s
Badlands

* * *

>s
Cave Wall
You can see trapdoor here.

>unlock trapdoor
(with key)
You unlock trapdoor.

>donw
That's not a verb I recognise.

>down
(first opening trapdoor)

Generator
You can see trapdoor here.

>down
The Core

* * *

>up
Cave Wall
You can see trapdoor here.

>n
Badlands

>n
HOME
You can see Backpack (closed) here.

>w
Well

>e
HOME
You can see Backpack (closed) here.

>e
Shop

>w
HOME
You can see Backpack (closed) here.

>n
City Entrance

>n
SURFACE

* * *

>s
HOME
Your home is on the outskirts of the city. A really old, cramped apartment that's falling apart. Everything is falling apart, from the floor, to the sink, to the bed, everything. There is a jalousie window on the back wall. Its panes look clean. A single faded yellow lightbulb illuminates the whole room.

You can see Backpack (closed) here.

>w
Well
One of those old-timey wells made of bricks and a wooden frame, in the empty western part of the city. Examine the handle to learn how to use it.

You can see a bucket (empty) and Handle here.

>x handle
A wide vertical triangular handle, painted bright red.

Push to drop the bucket in the well, pull to pull it out.

>push handle
The bucket isn't connected to the well. Try using something to connect it to the well.

>test one
(Testing.)

>[1] put on backpack
You can't see any such thing.

>[2] w
You can't go that way.

>[3] open backpack
You can't see any such thing.

>[4] take rope
You can't see any such thing.

>[5] put rope on bucket
You can't see any such thing.

>[6] connect bucket to well
The bucket isn't connected to the well. Try using something to connect it to the well.

>[7] push handle
The bucket isn't connected to the well. Try using something to connect it to the well.

>[8] pull handle
tie

>[9] take helmet
Taken.

>[10] e

HOME
Your home is on the outskirts of the city. A really old, cramped apartment that's falling apart. Everything is falling apart, from the floor, to the sink, to the bed, everything. There is a jalousie window on the back wall. Its panes look clean. A single faded yellow lightbulb illuminates the whole room.

You can see Backpack (closed) here.

* * *

>n
City Entrance
At the mouth of the cave, there's a heavy, bustling steampunk atmosphere, densely populated by humans and cyborgs. There are clotheslines which stretch from building to building and wide, rusty metal pipes that clunkily wind around the walls. Embedded in a wall on the side of a road is a molecular splitter, where one can buy an oxygen tank. Leaning on the wall a few feet away from it stands a tall, flamboyant man.

You can see a Walker, Molecular Splitter (empty) and a coin here.

>talk to walker
Howdy!

* * *

>n
City Entrance
At the mouth of the cave, there's a heavy, bustling steampunk atmosphere, densely populated by humans and cyborgs. There are clotheslines which stretch from building to building and wide, rusty metal pipes that clunkily wind around the walls. Embedded in a wall on the side of a road is a molecular splitter, where one can buy an oxygen tank. Leaning on the wall a few feet away from it stands a tall, flamboyant man.

You can see a Walker, Molecular Splitter (empty) and a coin here.

>w
You can't go that way.

>s
HOME
You can see Backpack (closed) here.

>w
Well
You can see Bucket and Crank here.

* * *

>n
City Entrance
At the mouth of the cave, there's a heavy, bustling steampunk atmosphere, densely populated by humans and cyborgs. There are clotheslines which stretch from building to building and wide, rusty metal pipes that clunkily wind around the walls. Embedded in a wall on the side of a road is a molecular splitter, where one can buy an oxygen tank. Leaning on the wall a few feet away from it stands a tall, flamboyant man.

You can see a Walker, Molecular Splitter (empty) and a coin here.

>x banner
WELCOME TO
EL TELLAGA TYNE

* * *

>open back
You can't see any such thing.

>open backpack
You open Backpack, revealing Metal Bar, Knife, Canvas Sheet, space suit, helmet and oxygen tank.

>take space suit
Taken.

>take helmet
Taken.

>take oxygen tank
Taken.

>put on helmet
You put on helmet.

>put on oxygen tank
You put on oxygen tank.

>s
Badlands

* * *

>open backpack
You open Backpack, revealing metal bar, rope and potato.

>close backpack
You close Backpack.

>open backpack
You open Backpack, revealing Metal Bar, Knife and Canvas Sheet.

* * *

>close backpack
You close Backpack.

>put on backpack
(first taking Backpack)
You put on Backpack.

>n
City Entrance

>w
You can't go that way.

>s
HOME

>w
Well
You can see Bucket here.

>e
HOME

>e
Shop

* * *

>open backpack
You open Backpack, revealing metal bar, rope and potato.

>get rope
Taken.

>i
You are carrying:
  Rope

* * *

>open backpack
You open Backpack, revealing metal bar, rope and potato.

>n
City Entrance

>s
HOME
You can see Backpack (in which are Potato, Metal Bar, Knife and Canvas Sheet) here.

>w
Well
You can see Bucket here.

>e
HOME
You can see Backpack (in which are Potato, Metal Bar, Knife and Canvas Sheet) here.

>e
Shop
You can see Flint here.

* * *

>w
You can't go that way.

>s
HOME
You can see Backpack (in which are Potato, Metal Bar, Knife and Canvas Sheet) here.

* * *

>e
Shop
You can see Flint here.

>get flint
Taken.

* * *

>open backpack
You open Backpack, revealing metal bar, rope and potato.

>take space suit
Taken.

* * *

>take oxygen tank
Taken.

>connect helmet to oxygen tank
You put helmet into oxygen tank.

>put on space suit
You can't wear that!

>i
You are carrying:
  oxygen tank
    helmet
  space suit
  key

* * *

>take oxygen tank
Taken.

>put on space suit
You put on space suit.

>connect helmet to oxygen tank
You put helmet into oxygen tank.

>put on helmet
(first taking helmet)
You put on helmet.

>put on oxygen tank
You put on oxygen tank.

>s
Badlands

    *** You can't breathe ***

Would you like to RESTART, RESTORE a saved game, QUIT or UNDO the last command?

* * *

>put on space suit
You put on space suit.

>connect helmet with oxygen tank
I didn't understand that sentence.

>connect helmet to oxygen tank
You put helmet into oxygen tank.

>s
Badlands

* * *

>put on space suit
You put on space suit.

>put on helmet
You put on helmet.

* * *

>put on oxygen tank
You put on oxygen tank.

I beg your pardon?

>s
Badlands

* * *

>put on oxygen tank
You put on oxygen tank.

>connect helmet to oxygen tank
(first taking it off)
You put helmet into oxygen tank.

>s
Badlands

    *** You can't breathe ***

Would you like to RESTART, RESTORE a saved game, QUIT or UNDO the last command?

* * *

>take space suit
Taken.

>w
Well
You can see a bucket and Crank here.

>look in well
the walker was right. helmet

>ne
City Entrance
You can see Molecular Splitter (empty) and a coin here.

>sw
Well
You can see a bucket and Crank here.

>ne
City Entrance
You can see Molecular Splitter (empty) and a coin here.

>se
Shop

>ne
You can't go that way.

>nw
City Entrance
You can see Molecular Splitter (empty) and a coin here.

* * *

>open backpack
You open Backpack, revealing metal bar, rope and potato.

>w
Well
You can see a bucket (empty) and Handle here.

>e
HOME
Your home is on the outskirts of the city.

You can see Backpack (in which are metal bar, rope and potato) here.

>pick up backpack
Taken.

>n
City Entrance
A heavy, bustling steampunk atmosphere, densely populated by humans and cyborgs. There are clotheslines which stretch from building to building and wide, rusty metal pipes that clunkily wind around the walls. Embedded in a wall on the side of a road is a molecular splitter, where one can buy an oxygen tank. Leaning on the wall a few feet away from it stands a tall, flamboyant man.

You can see a Walker, Molecular Splitter (empty) and a coin here.

>pick up coin
Taken.

>walker
That's not a verb I recognise.

>coin
That's not a verb I recognise.

>talk to walker
"Hello there!"

Ask him about:
 - his job
 - the city
 - his life i guess?
 - earth
 - where he got his clothes

>ask him about where he got his clothes
"You like this outfit? I got all this for 60 credits at that thrift store down the road!" He cranes his neck in that general direction. "Looks like they're closed. Oh well. Hey, you should check it out sometime!"

>s
HOME
Your home is on the outskirts of the city.

>w
Well
You can see a bucket (empty) and Handle here.

>open backpack
That's already open.

>take rope
Taken.

>tie to bucket
You can't see any such thing.

>tie bucket
What do you want to tie the bucket to?

>rope
Now you can connect the bucket to the well.

>connect
What do you want to connect?

>connect bucket to well
You connect the bucket to the well.

>examine handle
A wide vertical triangular handle, painted bright red.

Push to drop the bucket in the well, pull to pull it out.

>push
What do you want to push?

>bucket in the well
I only understood you as far as wanting to push the bucket inside.

>inside well
I only understood you as far as wanting to (go) inside the bucket inside.

>push bucket into well
You can't see any such thing.

>push handle
You push the handle, and the bucket goes into the well

>pull handle
helmet in bucket

>put helmet in backpack
You put helmet in your backpack.

>close backpack
You close Backpack.

>northeast
City Entrance
A heavy, bustling steampunk atmosphere, densely populated by humans and cyborgs. There are clotheslines which stretch from building to building and wide, rusty metal pipes that clunkily wind around the walls. Embedded in a wall on the side of a road is a molecular splitter, where one can buy an oxygen tank. Leaning on the wall a few feet away from it stands a tall, flamboyant man.

You can see a Walker and Molecular Splitter (empty) here.

>open backpack
You open Backpack, revealing helmet, metal bar and potato.

>i
You are carrying:
  a coin
  Backpack (open)
    helmet
    metal bar
    potato
  key

>take coin out
I only understood you as far as wanting to take the coin.

>coin
That's not a verb I recognise.

>take the coin out
I only understood you as far as wanting to take the coin.

>take coin out
I only understood you as far as wanting to take the coin.

>put coin into Molecular Splitter
You put the coin into Molecular Splitter.

>i
You are carrying:
  Backpack (open)
    helmet
    metal bar
    potato
  key

>take coin
Taken.

>put coin into splitter
You put the coin into Molecular Splitter.

>take coin
Taken.

>put coin in splitter
breathe yes haha

>i
You are carrying:
  oxygen tank
  a coin
  Backpack (open)
    helmet
    metal bar
    potato
  key

>put oxygen tank in backpack
You put oxygen tank in your backpack.

>close backpack
You close Backpack.

>talk to walker
"Howdy!"

Ask him about:
 - his job
 - the city
 - his life i guess?
 - earth
 - where he got his clothes

>ask him about earth
"Aiiii, that old pile of junk. Information-age peoples gunked it up like a few thousand Earth years ago or something like that. All the smart people got on ships and flew up here. That's how the story goes, I guess."

* * *

I beg your pardon?

>ask him for space suit
"This might sound like an odd question, but do you happen to have an extra space suit? I'm going to try to fix the generator and find out what's been causing these electrical disturbances lately," you say.

"Ah yes, I do just so happen to have one, my boyfriend quit his job as a Walker not too long ag--wait, fix the generator?"

He ponders this for a second. "Oh-kay, I can tell anyone who asks that you're with us, but I'm gonna have to ask for something in return."

Try offering him something in your backpack.

>potato
That's not a verb I recognise.

>give him potato
You can't see any such thing.

>open backpack
You open Backpack, revealing oxygen tank, helmet, metal bar and potato.

>take out potato
I only understood you as far as wanting to take outside.

>I summon thee ultimate potato god
I only understood you as far as wanting to take inventory.

>take potato
Taken.

>offer walker potato
"Ah! A potato! Finally, I've been starving all day! Thank you so much!"

He takes the potato, and gives you a space suit.

>YEEEEEEEE
That's not a verb I recognise.

>I
You are carrying:
  space suit
  a coin
  Backpack (open)
    oxygen tank
    helmet
    metal bar
  key

>put on space suit
You put on space suit.

>put on oxygen tank
(first taking oxygen tank)
You put on oxygen tank.

I beg your pardon?

>put on helmet
(first taking helmet)
You put on helmet.

>YEEEEEEEEEEEEEEEEEEEEEE WE DID IT!!!!!!!!!!
That's not a verb I recognise.

>take oxygen tank
You already have that.

>put on oxygen tank
You're already wearing that!

>i
You are carrying:
  helmet (being worn)
  oxygen tank (being worn)
  space suit (being worn)
  a coin
  Backpack (open)
    metal bar
  key

>s
HOME
Your home is on the outskirts of the city.

>s
The Badlands
Just outside the city is a massive cave heading down. Around three stories tall, hundreds of feet wide. even more straight ahead. The sides of the cave are lit by long strips of LED displays, each solid lime green.

>s
Cave Wall
The end of the cave. A trapdoor sits flush in the ground, caked by a thin layer of moondust.

You can see trapdoor here.

>examine trap door
You can't see any such thing.

>i
You are carrying:
  helmet (being worn)
  oxygen tank (being worn)
  space suit (being worn)
  a coin
  Backpack (open)
    metal bar
  key

>use key with trap door
That's not a verb I recognise.

>take out key
I only understood you as far as wanting to take outside.

>open backpack
That's already open.

>take key
You already have that.

>unlock trap door
You can't see any such thing.

>unlock trapdoor
What do you want to unlock trapdoor with?

>key
You unlock trapdoor.

>d
(first opening trapdoor)

Generator
You can see trapdoor and Surge Protector (closed) here.

>d
The Core
A giant translucent orange crystal. This seems to be the main source of power for the city. 

You can see Crystal (on which is piece of crystal) here.

>crack crystal
(Crystal)
Violence isn't the answer to this one.

>break crystal
(Crystal)
Violence isn't the answer to this one.

>unleash the beast
That's not a verb I recognise.

>take crystal
(Crystal)
That's fixed in place.

>take piece of crystal
Cautiously, you reach both hands towards the glowing orange piece of the crystal.

>i
You are carrying:
  piece of crystal
  helmet (being worn)
  oxygen tank (being worn)
  space suit (being worn)
  a coin
  Backpack (open)
    metal bar
  key

>u
Generator
You can see trapdoor and Surge Protector (closed) here.

>u
Cave Wall
The end of the cave. A trapdoor sits flush in the ground, caked by a thin layer of moondust.

You can see trapdoor here.

I beg your pardon?

>n
The Badlands
Just outside the city is a massive cave heading down. Around three stories tall, hundreds of feet wide. even more straight ahead. The sides of the cave are lit by long strips of LED displays, each solid lime green.

>s
Cave Wall
The end of the cave. A trapdoor sits flush in the ground, caked by a thin layer of moondust.

You can see trapdoor here.

>n
The Badlands
Just outside the city is a massive cave heading down. Around three stories tall, hundreds of feet wide. even more straight ahead. The sides of the cave are lit by long strips of LED displays, each solid lime green.

>n
HOME
Your home is on the outskirts of the city.

>n
City Entrance
A heavy, bustling steampunk atmosphere, densely populated by humans and cyborgs. There are clotheslines which stretch from building to building and wide, rusty metal pipes that clunkily wind around the walls. Embedded in a wall on the side of a road is a molecular splitter, where one can buy an oxygen tank. Leaning on the wall a few feet away from it stands a tall, flamboyant man.

You can see a Walker and Molecular Splitter (empty) here.

>n
SURFACE

    *** YOU WIN ***

Would you like to RESTART, RESTORE a saved game, QUIT or UNDO the last command?

* * *

>open backpack
You open Backpack, revealing metal bar, rope and potato.

>x metal bar
You see nothing special about metal bar.

>x knife
You see nothing special about knife.

>eat potato
(first taking potato)
You eat potato. Not bad.

>w
Well
You can see a bucket (empty) and Handle here.

>x bucket
A rusty metal bucket

>x handle
You see nothing special about Handle.

>take bucket
Taken.

>take handle
Taken.

>e
HOME
You can see Backpack (in which are metal bar, knife and rope) here.

>e
You can't go that way.

>n
City Entrance
You can see a Walker, Molecular Splitter (empty) and a coin here.

>x walker
A rather tall man, about six-foot-four, wearing a brown dress shirt, black vest, deep blue jeans, black boots. Lanky too, and his strawberry blond hair goes down to his shoulders in waves. He appears pretty feminine.

>talk to walker
"Howdy!"

Ask him about:
 - his job
 - the city
 - his life i guess?
 - earth
 - where he got his clothes

>ask walker about his job
"Oh, Walkers like myself are just people who go outside. Y'know, collect-slash-analyze moondust samples, scout for water ice, et cetera. Nerd stuff."

>ask walker where he got his clothes
I didn't understand that sentence.

>ask walker about where he got his clothes
"You like this outfit? I got all this for 60 credits at that thrift store down the road!" He cranes his neck in that general direction. "Looks like they're closed. Oh well. Hey, you should check it out sometime!"

>ask walker about the city
"You must not be from around these parts, huh?" He vaguely gestures with an open hand to everything.

"This is El Tellaga Tyne! Quite a mouthful, yes, I know. One of the older lunar cities, I think. It's been around for several hundred Earth years. And that's all I know, I'm no historian or anything."

>ask walker about his life
"Oh! I forgot to introduce myself! How rude of me, I'm so sorry. I'm Fara. I'm about twenty...five, six? Iunno, time flies so fast sometimes. I live around the urban part of the city with my boyfriend, Elair. The sweetest thing, that man is... Ah! You were saying?"

>ask walker about earth
"Aiiii, that old pile of junk. Information-age peoples gunked it up like a few thousand Earth years ago or something like that. All the smart people got on ships and flew up here. That's how the story goes, I guess."

>x molecular splitter
Molecular Splitter is empty.

>take molecular splitter
Taken.

>x coin
You see nothing special about the coin.

>take coin
Taken.

>put coin in molecular splitter
breathe yes haha

>give potato to walker
You can't see any such thing.

>open backpack
You can't see any such thing.

>s
HOME
You can see Backpack (in which are metal bar, knife and rope) here.

>take backpack
Taken.

>n
City Entrance
You can see a Walker here.

>open backpack
That's already open.

>give potato to walker
You can't see any such thing.

>s
HOME

>e
You can't go that way.

>w
Well

>undo
HOME
[Previous turn undone.]

>s
Badlands

    *** You can't breathe ***

Would you like to RESTART, RESTORE a saved game, QUIT or UNDO the last command?

>undo
HOME
[Previous turn undone.]

>w
Well

* * *

>e
HOME

>n
City Entrance
You can see a Walker here.

>restart
Are you sure you want to restart?

>yes
LOMIRA
An Interactive Fiction by kroberts21
Release 1 / Serial number 190415 / Inform 7 build 6M62 (I6/v6.33 lib 6/12N) SD

HOME
You can see Backpack (closed) here.

>take backpack
Taken.

>n
City Entrance
You can see a Walker, Molecular Splitter (empty) and a coin here.

>give potato to walker
You can't see any such thing.

>open backpack
You open Backpack, revealing metal bar, knife, rope and potato.

>give potato to walker
(first taking potato)

>take molecular splitter
Taken.

>take coin
Taken.

* * *

>put coin in molecular splitter
breathe yes haha

>talk to walker
"Hello there!"

Ask him about:
 - his job
 - the city
 - his life i guess?
 - earth
 - where he got his clothes

>ask walker for spacesuit
"This might sound like an odd question, but do you happen to have an extra space suit? I'm going to try to fix the generator and find out what's been causing these electrical disturbances lately," you say.

"Ah yes, I do just so happen to have one, my boyfriend quit his job as a Walker not too long ag--wait, fix the generator?"

He ponders this for a second. "Oh-kay, I can tell anyone who asks that you're with us, but I'm gonna have to ask for something in return."

Try offering him something in your backpack.

>i
You are carrying:
  oxygen tank
  a coin
  Molecular Splitter
  Backpack (open)
    metal bar
    knife
    rope
  key

>restart
Are you sure you want to restart?

* * *

>yes
LOMIRA
An Interactive Fiction by kroberts21
Release 1 / Serial number 190415 / Inform 7 build 6M62 (I6/v6.33 lib 6/12N) SD

HOME
You can see Backpack (closed) here.

>put on backpack
(first taking Backpack)
You put on Backpack.

>n
City Entrance
You can see a Walker, Molecular Splitter (empty) and a coin here.

>talk to walker
"Howdy!"

Ask him about:
 - his job
 - the city
 - his life i guess?
 - earth
 - where he got his clothes

I beg your pardon?

>ask him for spacesuit
"This might sound like an odd question, but do you happen to have an extra space suit? I'm going to try to fix the generator and find out what's been causing these electrical disturbances lately," you say.

"Ah yes, I do just so happen to have one, my boyfriend quit his job as a Walker not too long ag--wait, fix the generator?"

He ponders this for a second. "Oh-kay, I can tell anyone who asks that you're with us, but I'm gonna have to ask for something in return."

Try offering him something in your backpack.

>i
You are carrying:
  Backpack (being worn and closed)
  key

>open backpack
You open Backpack, revealing metal bar, knife, rope and potato.

* * *

>give potato to walker
(first taking potato)

>undo
City Entrance
[Previous turn undone.]

>give walker potato
(first taking potato)
"Ah! A potato! Finally, I've been starving all day! Thank you so much!"

He takes the potato, and gives you a space suit.

>take spacesuit
You already have that.

>put on spacesuit
You put on space suit.

>i
You are carrying:
  space suit (being worn)
  Backpack (being worn and open)
    metal bar
    knife
    rope
  key

>take coin
Taken.

* * *

>put coin in molecular splitter
breathe yes haha

>i
You are carrying:
  oxygen tank
  a coin
  space suit (being worn)
  Backpack (being worn and open)
    metal bar
    knife
    rope
  key

>put on oxygen tank
You put on oxygen tank.

>s
HOME

>w
Well
You can see a bucket (empty) and Handle here.

>i
You are carrying:
  oxygen tank (being worn)
  a coin
  space suit (being worn)
  Backpack (being worn and open)
    metal bar
    knife
    rope
  key

>put rope on bucket
(first taking rope)
Putting things on the bucket would achieve nothing.

>put rope on handle
Putting things on Handle would achieve nothing.

>tie rope to bucket
Now you can connect the bucket to the well.

>connect bucket to teh well
You can't see any such thing.

>connect bucket to well
You connect the bucket to the well.

>pull handle
helmet in bucket

>push handle
You push the handle, and the bucket goes into the well

>take the helmet
You can't see any such thing.

>take helmet
You can't see any such thing.

>push handle
You push the handle, and the bucket goes into the well

* * *

>pull handle
helmet in bucket

>take helmet
Taken.

>put on helmet
You put on helmet.

>e
HOME

>s
Badlands

* * *

>s
Cave Wall
You can see trapdoor here.

>i
You are carrying:
  helmet (being worn)
  oxygen tank (being worn)
  a coin
  space suit (being worn)
  Backpack (being worn and open)
    metal bar
    knife
  key

>open trapdoow
You can't see any such thing.

>open trapdoor
It seems to be locked.

>unlock trapdoor
What do you want to unlock trapdoor with?

>unlock trapdoor with key
You unlock trapdoor.

>open trapdoor
You open trapdoor.

>x trapdoor
You see nothing special about trapdoor.

>d
Generator
You can see trapdoor and Surge Protector (closed) here.

>x surge protector
You see nothing special about Surge Protector.

>open surge protector
You open Surge Protector, revealing On/Off Switch and Capacitors.

>x capacitor
In Capacitors is faulty bar.

>x faulty bar
You see nothing special about faulty bar.

>replace faulty bar
That's not a verb I recognise.

>put metal bar in capacitor
You replace the faulty bar with a new one.

>x switch
On/Off Switch is currently switched on.

>turn switch off
You switch it off.

>turn switch on
You switch it on, and the generator works like new.

>d
The Core
A giant orange crystal

You can see Crystal (on which is piece of crystal) here.

>take crystal
(Crystal)
That's fixed in place.

>x crystal
(Crystal)
On Crystal is piece of crystal.

>take piece of crystal
Cautiously, you reach both hands towards the glowing orange piece of the crystal.

>u
Generator
You can see trapdoor and Surge Protector (in which are On/Off Switch and Capacitors (in which are metal bar and faulty bar)) here.

>u
Cave Wall
You can see trapdoor here.

>n
Badlands

>n
HOME

>n
City Entrance
You can see a Walker and Molecular Splitter (empty) here.

>n
SURFACE

    *** YOU WIN ***

Would you like to RESTART, RESTORE a saved game, QUIT or UNDO the last command?

* * *

>purloin helmet
[Purloined.]

>purloin space suit
[Purloined.]

>purloin oxygen tank
[Purloined.]

>i
You are carrying:
  oxygen tank
  space suit
  helmet
  key

>put on oxygen tank
You put on oxygen tank.

>put on helmet
You put on helmet.

>put on space suit
You put on space suit.

>s
Badlands

I beg your pardon?

>s
Cave Wall
You can see trapdoor here.

>open trapdoor
It seems to be locked.

* * *

>unlock trapdoor with key
You unlock trapdoor.

>down
(first opening trapdoor)

Generator
You can see trapdoor here.

* * *

>put key is bucket
I didn't understand that sentence.

>put key in bucket
You can't see any such thing.

>w
Well
You can see a bucket (empty), Lever and Button here.

>put key in bucket
This isn't a valid piece of currency. Try putting in the coin.

* * *

>put on backpac
You can't see any such thing.

>put on backpck
You can't see any such thing.

>put on backpack
(first taking Backpack)
You put on Backpack.

>w
Well
You can see a bucket (empty) and Handle here.

>open backpack
You open Backpack, revealing metal bar, knife, canvas sheet, rope and potato.

>take rope
Taken.

>close backpack
You close Backpack.

>tie rope to bucket
Now you can connect the bucket to the well.

>connect bucket to well
You connect the bucket to the well.

>look
Well
You can see Handle here.

>push handle
You push the handle, and the bucket goes into the well

* * *

>take helmet
Taken.

>take bucket
Taken.

* * *

>put on backpack
(first taking Backpack)
You put on Backpack.

* * *

>n
City Entrance
You can see a Walker, Molecular Splitter (empty) and a coin here.

>talk to walker
"Hello there!"

Ask him about:
 - his job
 - the city
 - his life i guess?
 - earth
 - where he got his clothes

>ask him for space suit
"This might sound like an odd question, but do you happen to have an extra space suit? I'm going to try to fix the generator and find out what's been causing these electrical disturbances lately," you say.

"Ah yes, I do just so happen to have one, my boyfriend quit his job as a Walker not too long ag--wait, fix the generator?"

He ponders this for a second. "Oh-kay, I can tell anyone who asks that you're with us, but I'm gonna have to ask for something in return."

Try offering him something in your backpack.

>open backpack
You open Backpack, revealing metal bar, knife, canvas sheet, rope and potato.

>take potato
Taken.

* * *

>offer walker potato
"Ah! A potato! Finally, I've been starving all day! Thank you so much!"

He takes the potato, and gives you a space suit.

>s
HOME

* * *

>w
Well
You can see a bucket (empty) and Handle here.

>i
You are carrying:
  space suit
  Backpack (being worn and open)
    metal bar
    knife
    canvas sheet
    rope
  key

>take rope
Taken.

>tie rope to bucket
Now you can connect the bucket to the well.

* * *

>connect bucket to well
You connect the bucket to the well.

>push handle
You push the handle, and the bucket goes into the well

* * *

>pull handle
helmet in bucket

>i
You are carrying:
  space suit
  Backpack (being worn and open)
    metal bar
    knife
    canvas sheet
  key

>take helmet
Taken.

>e
HOME

>n
City Entrance
You can see a Walker, Molecular Splitter (empty) and a coin here.

>take coin
Taken.

* * *

>put coin in splitter
breathe yes haha

>i
You are carrying:
  oxygen tank
  a coin
  helmet
  space suit
  Backpack (being worn and open)
    metal bar
    knife
    canvas sheet
  key

>put on helmet
You put on helmet.

* * *

>put on space suit
You put on space suit.

>put on oxygen tank
You put on oxygen tank.

* * *

>s
HOME

>s
Badlands

* * *

>put on backpack
(first taking Backpack)
You put on Backpack.

>open backpack
You open Backpack, revealing Metal Bar, Knife, Canvas Sheet, space suit, helmet and oxygen tank.

* * *

>put on backpack
(first taking Backpack)
You put on Backpack.

>s
Badlands

    *** You can't breathe ***

Would you like to RESTART, RESTORE a saved game, QUIT or UNDO the last command?

* * *

>w
Well
You can see a bucket (empty) and Handle here.

>connect bucket to well
tie

>i
You are carrying:
  Backpack (being worn and closed)
  key

* * *

>w
Well
You can see a bucket (empty) and Handle here.

>e
HOME
Your home is on the outskirts of the city. An old apartment

>e
You can't go that way.

>n
City Entrance
A heavy, bustling steampunk atmosphere, densely populated by humans and cyborgs. There are clotheslines which stretch from building to building and wide, rusty metal pipes that clunkily wind around the walls. Embedded in a wall on the side of a road is a molecular splitter, where one can buy an oxygen tank. Leaning on the wall a few feet away from it stands a tall, flamboyant man.

You can see a Walker, Molecular Splitter (empty) and a coin here.

>s
HOME
Your home is on the outskirts of the city. An old apartment

* * *

>w
Well
You can see a bucket (empty) and Handle here.

>open backpac
You can't see any such thing.

>open backpack
You open Backpack, revealing Metal Bar, Knife, Canvas Sheet, Rope, space suit and helmet.

>take rope
Taken.

* * *

>put coin in splitter
breathe yes haha

>talk to walker
"Howdy!"

Ask him about:
 - his job
 - the city
 - his life i guess?
 - earth
 - where he got his clothes

>ask him about his job
"Oh, Walkers like myself are just people who go outside. Y'know, collect-slash-analyze moondust samples, scout for water ice, et cetera. Nerd stuff."

>x walker
A rather tall man, about six-foot-four, wearing a brown dress shirt, black vest, deep blue jeans, black boots. Lanky too, and his strawberry blond hair goes down to his shoulders in waves. He appears pretty feminine.

>ask him about the city
"You must not be from around these parts, huh?" He vaguely gestures with an open hand to everything.

"This is El Tellaga Tyne! Quite a mouthful, yes, I know. One of the older lunar cities, I think. It's been around for several hundred Earth years. And that's all I know, I'm no historian or anything."

>ask him about his life
"Oh! I forgot to introduce myself! How rude of me, I'm so sorry. I'm Fara. I'm about twenty...five, six? Iunno, time flies so fast sometimes. I live around the urban part of the city with my boyfriend, Elair. The sweetest thing, that man is... Ah! You were saying?"

>ask him about earth
"Aiiii, that old pile of junk. Information-age peoples gunked it up like a few thousand Earth years ago or something like that. All the smart people got on ships and flew up here. That's how the story goes, I guess."

>ask him about his clothes
"You like this outfit? I got all this for 60 credits at that thrift store down the road!" He cranes his neck in that general direction. "Looks like they're closed. Oh well. Hey, you should check it out sometime!"

>ask him for spacesuit
"This might sound like an odd question, but do you happen to have an extra space suit? I'm going to try to fix the generator and find out what's been causing these electrical disturbances lately," you say.

"Ah yes, I do just so happen to have one, my boyfriend quit his job as a Walker not too long ag--wait, fix the generator?"

He ponders this for a second. "Oh-kay, I can tell anyone who asks that you're with us, but I'm gonna have to ask for something in return."

Try offering him something in your backpack.

>open backpack
You open Backpack, revealing metal bar, knife, canvas sheet and potato.

>take potato
Taken.

>give walker potato
"Ah! A potato! Finally, I've been starving all day! Thank you so much!"

He takes the potato, and gives you a space suit.

>put on helmet
You put on helmet.

* * *

>take rope
Taken.

>tie bucket to rope
You tie the the bucket to the Rope.

*** Run-time problem P15: You can't move nothing.

Now you can connect the bucket to the well.

>i
You are carrying:
  Backpack (being worn and open)
    Metal Bar
    Knife
    Canvas Sheet
    space suit
    helmet
  key

>pick up contraption
You can't see any such thing.

* * *

>connect bucket to well
You connect the bucket to the well.

>i
You are carrying:
  Rope
  Backpack (being worn and open)
    Metal Bar
    Knife
    Canvas Sheet
    space suit
    helmet
  key

* * *

>connect bucket to well
You connect the bucket to the well.

>pull lever
You pull the lever down, and the bucket goes into the well

* * *

>push button
helmet in bucket

>take helmet
Taken.

* * *

>open backpack
You open Backpack, revealing metal bar, knife, canvas sheet, rope and potato.

>tie rope to bucket
You might want to tie it to the well with something.

>take rope
Taken.

* * *

>pull lever
You pull the lever down, and the bucket goes into the well

>push button
helmet in bucket

* * *

>w
Well
You can see a bucket (empty) and Handle here.

>push handle
tie

>pull handle
tie

>open backpack
You open Backpack, revealing metal bar, knife, canvas sheet, rope and potato.

* * *

>tie rope to bucket
Now you can connect the bucket to the well.

>connect bucket to wel
You can't see any such thing.

>connect bucket to well
You connect the bucket to the well.

* * *

>w
Well
You can see a bucket (empty) and Handle here.

>x bucket
A rusty metal bucket

In the bucket is helmet.

* * *

>put on bucket
You can't see any such thing.

>yeah
That's not a verb I recognise.

* * *

>s
Badlands

    *** You can't breathe ***

Would you like to RESTART, RESTORE a saved game, QUIT or UNDO the last command?

>s
Cave Wall
You can see trapdoor here.

>down
Generator

>down
The Core

* * *

>s
Cave Wall
You can see trapdoor here.

>n
Badlands

* * *

>s
Cave Wall
You can see trapdoor here.

>ss
That's not a verb I recognise.

>down
Generator

* * *

>take all
Backpack: Taken.

* * *

>test e
>--> The following tests are available:
'test me'

>test me
(Testing.)

>[1] put on backpack
(first taking Backpack)
You put on Backpack.

>[2] w

Well
You can see a bucket (empty), Lever and Button here.

>[3] open backpack
You open Backpack, revealing Metal Bar, Knife, Canvas Sheet, Rope and space suit.

>[4] take rope
Taken.

>[5] tie bucket to rope
Now you can connect the bucket to the well.

>[6] connect bucket to well
You connect the bucket to the well.

>pull lever
You pull the lever down, and the bucket goes into the well

>x bucket
You can't see any such thing.

>down
very very dark hole
You can see a bucket here.

>x bucket
A rusty metal bucket

>put key in bucket
This isn't a valid piece of currency. Try putting in the coin.

>x xwell
You can't see any such thing.

>up
Well
You can see Lever here.

>x xwell
helmet

In xwell is Rope.

>x bucket
You can't see any such thing.

* * *

>x bucket
A rusty metal bucket

>purloin bucket
[Purloined.]

>i
You are carrying:
  a bucket
    helmet
  Backpack (being worn and open)
    Metal Bar
    Knife
    Canvas Sheet
    space suit
  key

>purloin helmet
[Purloined.]

>i
You are carrying:
  helmet
  a bucket
  Backpack (being worn and open)
    Metal Bar
    Knife
    Canvas Sheet
    space suit
  key

* * *

>test me
(Testing.)

>[1] test one
(Testing.)

>[2] put on backpack
(first taking Backpack)
You put on Backpack.

>[3] w

Well
You can see a bucket (empty) and Handle here.

>[4] open backpack
You open Backpack, revealing metal bar, knife, canvas sheet, rope and potato.

>[5] take rope
Taken.

>[6] tie rope to bucket
Now you can connect the bucket to the well.

>[7] connect bucket to well
You connect the bucket to the well.

>[8] push handle
You push the handle, and the bucket goes into the well

>[9] pull handle
helmet in bucket

>[10] take helmet
Taken.

>[11] e

HOME

>[12] test two
(Testing.)

>[13] n

City Entrance
You can see a Walker, Molecular Splitter (empty) and a coin here.

>[14] talk to walker
"Hello there!"

Ask him about:
 - his job
 - the city
 - his life i guess?
 - earth
 - where he got his clothes

>[15] ask him about his life
"Oh! I forgot to introduce myself! How rude of me, I'm so sorry. I'm Fara. I'm about twenty...five, six? Iunno, time flies so fast sometimes. I live around the urban part of the city with my boyfriend, Elair. The sweetest thing, that man is... Ah! You were saying?"

>[16] ask him about his job
"Oh, Walkers like myself are just people who go outside. Y'know, collect-slash-analyze moondust samples, scout for water ice, et cetera. Nerd stuff."

>[17] ask him for spacesuit
"This might sound like an odd question, but do you happen to have an extra space suit? I'm going to try to fix the generator and find out what's been causing these electrical disturbances lately," you say.

"Ah yes, I do just so happen to have one, my boyfriend quit his job as a Walker not too long ag--wait, fix the generator?"

He ponders this for a second. "Oh-kay, I can tell anyone who asks that you're with us, but I'm gonna have to ask for something in return."

Try offering him something in your backpack.

>[18] open backpack
That's already open.

>[19] take potato
Taken.

>[20] give walker potato
"Ah! A potato! Finally, I've been starving all day! Thank you so much!"

He takes the potato, and gives you a space suit.

>[21] test three
(Testing.)

>[22] pick up coin
Taken.

>[23] put coin in splitter
breathe yes haha

>i
You are carrying:
  Backpack (being worn and open)
    Metal Bar
    Knife
    Canvas Sheet
    space suit
  key

>x bucket
A rusty metal bucket

>down
very very dark hole

>up
Well
You can see a bucket (empty) and Handle here.

* * *

>pull lever
You pull the lever down, and the bucket goes into the well

* * *

>push button
helmet in bucket

>x bucket
A rusty metal bucket

* * *

>down
very very dark hole

>x helmet
You can't see any such thing.

>up
Well
You can see a bucket, Lever and Button here.

>x helmet
You see nothing special about helmet.

* * *

>pull lever down
I only understood you as far as wanting to pull Lever.

* * *

>pull levr
You can't see any such thing.

>pull lever
You pull the lever down, and the bucket goes into the well

Nothing obvious happens.

* * *

>push button
You push the button, and the bucket goes into the well

>push button
helmet in bucket
You push the button, and the bucket goes into the well

* * *

>three times five
That's not a verb I recognise.

* * *

>turn crank left
I only understood you as far as wanting to turn Crank.

>turn crank right
I only understood you as far as wanting to turn Crank.

* * *

>turn crank right
I only understood you as far as wanting to turn Crank.

* * *

>test one
(Testing.)

>[1] put on backpack
(first taking Backpack)
You put on Backpack.

>[2] w

Well
One of those old-timey wells made of bricks and a wooden frame, in the empty western part of the city. Examine the handle to learn how to use it.

You can see a bucket (empty) and Handle here.

>[3] open backpack
You open Backpack, revealing metal bar, rope and potato.

>[4] take rope
Taken.

>[5] tie rope to bucket
Now you can connect the bucket to the well.

>[6] connect bucket to well
You connect the bucket to the well.

>[7] push handle
You push the handle, and the bucket goes into the well

>[8] pull handle
helmet in bucket

>[9] take helmet
Taken.

>[10] e

HOME
Your home is on the outskirts of the city. A really old, cramped apartment that's falling apart. Everything is falling apart, from the floor, to the sink, to the bed, everything. There is a jalousie window on the back wall. Its panes look clean. A single faded yellow lightbulb illuminates the whole room.

>test two
(Testing.)

>[1] n

City Entrance
At the mouth of the cave, there's a heavy, bustling steampunk atmosphere, densely populated by humans and cyborgs. There are clotheslines which stretch from building to building and wide, rusty metal pipes that clunkily wind around the walls. Embedded in a wall on the side of a road is a molecular splitter, where one can buy an oxygen tank. Leaning on the wall a few feet away from it stands a tall, flamboyant man.

You can see a Walker, Molecular Splitter (empty) and a coin here.

>[2] talk to walker
"Hello there!"

Ask him about:
 - his job
 - the city
 - his life i guess?
 - earth
 - where he got his clothes

>[3] ask him about his life
"Oh! I forgot to introduce myself! How rude of me, I'm so sorry. I'm Fara. I'm about twenty...five, six? Iunno, time flies so fast sometimes. I live around the urban part of the city with my boyfriend, Elair. The sweetest thing, that man is... Ah! You were saying?"

>[4] ask him about his job
"Oh, Walkers like myself are just people who go outside. Y'know, collect-slash-analyze moondust samples, scout for water ice, et cetera. Nerd stuff."

>[5] ask him for spacesuit
"This might sound like an odd question, but do you happen to have an extra space suit? I'm going to try to fix the generator and find out what's been causing these electrical disturbances lately," you say.

"Ah yes, I do just so happen to have one, my boyfriend quit his job as a Walker not too long ag--wait, fix the generator?"

He ponders this for a second. "Oh-kay, I can tell anyone who asks that you're with us, but I'm gonna have to ask for something in return."

Try offering him something in your backpack.

>[6] open backpack
That's already open.

>[7] take potato
Taken.

>[8] give walker potato
"Ah! A potato! Finally, I've been starving all day! Thank you so much!"

He takes the potato, and gives you a space suit.

>test three
(Testing.)

>[1] pick up coin
Taken.

>[2] put coin in splitter
breathe yes haha

>put on spacesuit
You put on space suit.

>put on helmet
You put on helmet.

* * *

>s
Cave Wall
You can see trapdoor here.

>unlock trapdoor with key
You unlock trapdoor.

* * *

>test three
(Testing.)

>[1] pick up coin
Taken.

>[2] put coin in splitter
breathe yes haha

>tes four
That's not a verb I recognise.

>test four
(Testing.)

>[1] put on oxygen tank
You put on oxygen tank.

>[2] put on spacesuit
You put on space suit.

>[3] put on helmet
You put on helmet.

>[4] s

HOME

>[5] s

Badlands

>[6] s

Cave Wall
You can see trapdoor here.

>[7] unlock trapdoor with key
You unlock trapdoor.

>[8] down
(first opening trapdoor)

Generator
You can see trapdoor and Surge Protector (closed) here.

>open surge protector
You open Surge Protector, revealing On/Off Switch and Capacitors.

>x capacitors
In Capacitors is faulty bar.

* * *

>test three
(Testing.)

>[1] pick up coin
Taken.

>[2] put coin in splitter
breathe yes haha

>test four
(Testing.)

>[1] put on oxygen tank
You put on oxygen tank.

>[2] put on spacesuit
You put on space suit.

>[3] put on helmet
You put on helmet.

>[4] s

HOME
Your home is on the outskirts of the city. A really old, cramped apartment that's falling apart. Everything is falling apart, from the floor, to the sink, to the bed, everything. There is a jalousie window on the back wall. Its panes look clean. A single faded yellow lightbulb illuminates the whole room.

>[5] s

The Badlands
Just outside the city is a massive cave heading down. Around three stories tall, hundreds of feet wide. even more straight ahead. The sides of the cave are lit by long strips of LED displays, each solid neon green.

>[6] s

Cave Wall
The end of the cave. A trapdoor sits flush in the ground, caked by a thin layer of moondust.

You can see trapdoor here.

>[7] unlock trapdoor with key
You unlock trapdoor.

>[8] down
(first opening trapdoor)

Generator
You can see trapdoor and Surge Protector (closed) here.

>down
The Core
A giant translucent orange crystal. This seems to be the main source of power for the city. 

You can see Giant Crystal (on which is piece of crystal) here.

>test six
(Testing.)

>[1] take piece of crystal
Cautiously, you reach both hands towards the glowing orange piece of the crystal.

>[2] up

Generator
You can see trapdoor and Surge Protector (closed) here.

>[3] up

Cave Wall
The end of the cave. A trapdoor sits flush in the ground, caked by a thin layer of moondust.

You can see trapdoor here.

>[4] n

The Badlands
Just outside the city is a massive cave heading down. Around three stories tall, hundreds of feet wide. even more straight ahead. The sides of the cave are lit by long strips of LED displays, each solid neon green.

>[5] n

HOME
Your home is on the outskirts of the city. An old apartment 

>[6] n

City Entrance
A heavy, bustling steampunk atmosphere, densely populated by humans and cyborgs. There are clotheslines which stretch from building to building and wide, rusty metal pipes that clunkily wind around the walls. Embedded in a wall on the side of a road is a molecular splitter, where one can buy an oxygen tank. Leaning on the wall a few feet away from it stands a tall, flamboyant man.

You can see a Walker and Molecular Splitter (empty) here.

>[7] n

SURFACE

    *** The moment you step foot outside the other end of the dome, the crystal in your hands starts to slowly levitate upwards. Stopping at around three feet in front of you, seven feet above the ground, it explodes, jettisoning orange shards out into space. When the smoke clears, you see a tiny gray humanoid figure, hovering where the crystal was. "Thank you," it says, and takes off toward the constellation Orion.  You forgot to fix the generator, but that's alright. Not your problem anymore.

YOU WIN ***

Would you like to RESTART, RESTORE a saved game, QUIT or UNDO the last command?

* * *

>open surge protector
You open Surge Protector, revealing On/Off Switch and Capacitors.

>close backpack
You close Backpack.

>turn switch off
You switch it off.

>x capacitors
In Capacitors is faulty bar.

>take faulty bar
Taken.

You remove the faulty bar from the capacitors.

>open backpack
You open Backpack, revealing metal bar and knife.

>take metal bar
Taken.

>put metal bar in capacitors
You replace the faulty bar with a new one.

>i
You are carrying:
  faulty bar
  oxygen tank (being worn)
  a coin
  space suit (being worn)
  helmet (being worn)
  Backpack (being worn and open)
    knife
  key

>down
The Core

* * *

>open surge protector
You open Surge Protector, revealing On/Off Switch and Capacitors.

>switch on
You must supply a noun.

>switch on
You must supply a noun.

>turn switch on
It's already on.

>switch off
You must supply a noun.

>turn switch off
It's already off.

* * *

>open surge protector
You open Surge Protector, revealing On/Off Switch and Capacitors.

>take switch
That's fixed in place.

* * *

>open surge protector
You open Surge Protector, revealing On/Off Switch and Capacitors.

>turn switch off
You switch it off.

* * *

>x capacitors
In Capacitors is faulty bar.

>remove faulty bar
You aren't wearing faulty bar.

You remove the faulty bar from the capacitors.

>put faulty bar in backpack
You put faulty bar in your backpack.

>i
You are carrying:
  oxygen tank (being worn)
  a coin
  space suit (being worn)
  helmet (being worn)
  Backpack (being worn and open)
    faulty bar
    metal bar
    knife
  key

>take metal bar
Taken.

* * *

>put metal bar in capacitors
You replace the faulty bar with a new one.

>turn switch on
You switch it on, and the generator works like new.

>down
The Core
You can see Crystal here.

>cut crystal
(Crystal)
Cutting it up would achieve little.

>cut crystal with knife
(Crystal with knife)

* * *

>remove faulty bar
You aren't wearing faulty bar.

You remove the faulty bar from the capacitors.

>take metal bar
Taken.

* * *

>down
The Core
You can see Crystal here.

>take knife
Taken.

>cut crystal with knife
(Crystal with knife)

* * *

>i
You are carrying:
  knife
  faulty bar
  oxygen tank (being worn)
  a coin
  space suit (being worn)
  helmet (being worn)
  Backpack (being worn and open but empty)
  key

* * *

>take faulty bar
Taken.

You remove the faulty bar from the capacitors.

>put faulty bar in backpack
You put the faulty bar in the bucket.

* * *

>take faulty bar
Taken.

You remove the faulty bar from the capacitors.

>undo
Generator
[Previous turn undone.]

>undo
Generator
[Previous turn undone.]

>x capacitors
In Capacitors is faulty bar.

>take faulty bar
Taken.

* * *

>x capacitors
In Capacitors is faulty bar.

>take faulty bar
Taken.

You might not want to do that.

>i
You are carrying:
  oxygen tank (being worn)
  a coin
  space suit (being worn)
  helmet (being worn)
  Backpack (being worn and open)
    metal bar
    knife
  key

>turn switch off
You switch it off.

>take faulty bar
Taken.

You remove the faulty bar from the capacitors.

>take metal bar
Taken.

* * *

>turn switch on
You switch it on, and the generator works like new.

>close surge protector
You close Surge Protector.

* * *

>open surge protector
You open Surge Protector, revealing On/Off Switch and Capacitors.

>x slot
You can't see any such thing.

>x capacitors
In Capacitors is faulty bar.

>take faulty bar out of capacitors
Taken.

>undo
Generator
[Previous turn undone.]

>remove faulty bar from capacitors
Taken.

* * *

>test five
(Testing.)

>[1] open surge protector
You open Surge Protector, revealing On/Off Switch and Capacitors.

>[2] turn switch off
You switch it off.

 Examine the capacitors.

>[3] x capacitors
You move a little closer to the capacitors.

Replace the faulty bar.

In Capacitors is faulty bar.

>[4] take faulty bar out of capacitors
I only understood you as far as wanting to take faulty bar.

>[5] take metal bar
Taken.

>[6] put metal bar in capacitors
You replace the faulty bar with a new one.

>[7] turn switch on
You switch it on, and the generator works like new.

>[8] down

The Core
A giant translucent orange crystal. This seems to be the main source of power for the city. 

You can see Giant Crystal (on which is piece of crystal) here.

>cut crystal with knife
(Crystal with knife)

* * *

>take knife
Taken.

* * *

>cut crystal with knife
(Crystal with knife)

>take piece of crystal
Taken.

>i
You are carrying:
  piece of crystal
  knife
  oxygen tank (being worn)
  a coin
  space suit (being worn)
  helmet (being worn)
  Backpack (being worn and open but empty)
  key

>n
You can't go that way.

>up
Generator
You can see trapdoor and Surge Protector (in which are On/Off Switch and Capacitors (in which are metal bar and faulty bar)) here.

>up
Cave Wall
You can see trapdoor here.

* * *

>take piece of crystal
Cautiously, you reach both hands towards the glowing orange piece of the crystal.

>up
Generator
You can see trapdoor and Surge Protector (in which are On/Off Switch and Capacitors (in which are metal bar and faulty bar)) here.

* * *

>n
SURFACE

    *** YOU WIN ***

Would you like to RESTART, RESTORE a saved game, QUIT or UNDO the last command?

>i
Please give one of the answers above.

Would you like to RESTART, RESTORE a saved game, QUIT or UNDO the last command?

* * *

>test six
(Testing.)

>[1] take piece of crystal
Cautiously, you reach both hands towards the glowing orange piece of the crystal.

>[2] up

Generator
You can see trapdoor and Surge Protector (in which are On/Off Switch and Capacitors (in which are metal bar and faulty bar)) here.

>[3] up

Cave Wall
The end of the cave. A trapdoor sits flush in the ground, caked by a thin layer of moondust.

You can see trapdoor here.

>[4] n

The Badlands
Just outside the city is a massive cave heading down. Around three stories tall, hundreds of feet wide. even more straight ahead. The sides of the cave are lit by long strips of LED displays, each solid neon green.

>[5] n

HOME
Your home is on the outskirts of the city. A really old, cramped apartment that's falling apart. Everything is falling apart, from the floor, to the sink, to the bed, everything. There is a jalousie window on the back wall. Its panes look clean. A single faded yellow lightbulb illuminates the whole room.

>[6] n

City Entrance
At the mouth of the cave, there's a heavy, bustling steampunk atmosphere, densely populated by humans and cyborgs. There are clotheslines which stretch from building to building and wide, rusty metal pipes that clunkily wind around the walls. Embedded in a wall on the side of a road is a molecular splitter, where one can buy an oxygen tank. Leaning on the wall a few feet away from it stands a tall, flamboyant man.

You can see a Walker and Molecular Splitter (empty) here.

>[7] n

SURFACE

    *** The moment you step foot outside the other end of the dome, the crystal in your hands starts to slowly levitate upwards. Stopping at around three feet in front of you, seven feet above the ground, it explodes, jettisoning orange shards out into space. When the smoke clears, you see a tiny gray humanoid figure, hovering where the crystal was. "Thank you," it says, and takes off toward the constellation Orion. 

YOU WIN ***

Would you like to RESTART, RESTORE a saved game, QUIT or UNDO the last command?

>i
Please give one of the answers above.

Would you like to RESTART, RESTORE a saved game, QUIT or UNDO the last command?

* * *

>turn lightbulb
You flinch, as it nearly burns your fingers.

>turn on lightbulb
It isn't something you can switch.

>take all
mm-mm.

* * *

>w
Well
You can see a bucket (empty) and Handle here.

>down
You can't go that way.

* * *

>w
Well
You can see a bucket (empty) and Handle here.

>e
HOME
You can see Backpack (closed) here.

>n
City Entrance

* * *

>n
SURFACE

>s
City Entrance

>s
HOME

* * *

>s
Badlands

>s
Cave Wall

>s
You can't go that way.

>down
You can't go that way.

>up
You can't go that way.

>n
Badlands

* * *

>n
HOME

>n
City Entrance

>w
Well

>e
City Entrance

>e
Shop

>w
City Entrance

>n
SURFACE

>n
You can't go that way.

* * *

>e
HOME
You can see Backpack (closed) here.

>put on backpac
You can't see any such thing.

>put on backpack
(first taking Backpack)
You put on Backpack.

* * *

>connect bucket to well
You connect the bucket to the well.

>pick up bucket
Taken.

>i
You are carrying:
  a bucket
  Backpack (being worn and closed)
  key

* * *

>e
HOME
You can see Backpack (closed) here.

>put on backpack
(first taking Backpack)
You put on Backpack.

* * *

>w
Well
You can see a bucket (empty) and Handle here.

>open backpack
You open Backpack, revealing Metal Bar, Knife, Canvas Sheet, Rope and space suit.

>put knife in bucket
You put the Knife in the bucket.

>take knife
Taken.

>put knife in backpack
You put the Knife in the bucket.

* * *

>open backpack
You open Backpack, revealing Metal Bar, Knife, Canvas Sheet, Rope and space suit.

>take rope
Taken.

* * *

>e
HOME
You can see Backpack (closed) here.

>w
Well
You can see a bucket (empty), Lever and Button here.

>take lever
Taken.

* * *

>w
Well
You can see a bucket (empty) and Handle here.

>look in well
helmet

* * *

>w
Well
You can see a bucket (empty) and Handle here.

>open backpack
You can't see any such thing.

>e
HOME
You can see Backpack (closed) here.

* * *

>put on backpack
(first taking Backpack)
You put on Backpack.

>w
Well
You can see Bucket and Crank here.

>open backpack
You open Backpack, revealing Metal Bar, Knife, Canvas Sheet, Rope, space suit, helmet and oxygen tank.

>take rope
Taken.

* * *

>close backpack
You close Backpack.

>tie bucket to rope
You tie the Bucket to the Rope.

*** Run-time problem P15: You can't move nothing.

* * *

>w
Well
You can see a bucket (empty) and Handle here.

>pick up bucket
Taken.

>drop bucket
Dropped.

>e
HOME
You can see Backpack (closed) here.

* * *

>take rope
Taken.

>close bacpack
You can't see any such thing.

>oops backpack
You close Backpack.

* * *

>w
Well
You can see a bucket (empty) and Handle here.

>pull handle
helmet in bucket

* * *

>w
Well
You can see a bucket (empty) and Handle here.

>push button
You push the button, and the bucket goes into the well

* * *

>push handle
tie

>pull handle
helmet in bucket

>take helmt
You can't see any such thing.

>take helmet
Taken.

* * *

>w
Well
You can see a bucket (empty) and Handle here.

>s
You can't go that way.

>s
You can't go that way.

>e
HOME
You can see Backpack (closed) here.

>s
Badlands

    *** You can't breathe ***

Would you like to RESTART, RESTORE a saved game, QUIT or UNDO the last command?

* * *

>w
Well
You can see a bucket (empty) and Handle here.

>take bucket
Taken.

>fill bucket with water
That's not a verb I recognise.

* * *

>w
Well
You can see a bucket (empty) and Handle here.

>take lever
That's fixed in place.

>push button
It is fixed in place.

* * *

>w
Well
You can see a bucket (empty) and Handle here.

>turn crank
Nothing obvious happens.

* * *

>x bucket
A rusty metal bucket

>x xwell
helmet

* * *

>w
Well
You can see a bucket (empty) and Handle here.

>x well
You can't see any such thing.

>look in well
You can't see any such thing.

* * *

>west
Well
You can see a bucket (empty) and Handle here.

>bucket
That's not a verb I recognise.

>x handle
A wide vertical triangular handle, painted bright red.

Push to drop the bucket in the well, pull to pull it out.

>push
(key)
tie

>e
HOME
Your home is on the outskirts of the city.

You can see Backpack (closed) here.

>open backpack
You open Backpack, revealing metal bar, rope and potato.

>rope
That's not a verb I recognise.

>metal bar
That's not a verb I recognise.

>n
City Entrance
A heavy, bustling steampunk atmosphere, densely populated by humans and cyborgs. There are clotheslines which stretch from building to building and wide, rusty metal pipes that clunkily wind around the walls. Embedded in a wall on the side of a road is a molecular splitter, where one can buy an oxygen tank. Leaning on the wall a few feet away from it stands a tall, flamboyant man.

You can see a Walker, Molecular Splitter (empty) and a coin here.

>talk to walker
"Howdy!"

Ask him about:
 - his job
 - the city
 - his life i guess?
 - earth
 - where he got his clothes

>ask about earth
You can't see any such thing.

>ask him about his life
"Oh! I forgot to introduce myself! How rude of me, I'm so sorry. I'm Fara. I'm about twenty...five, six? Iunno, time flies so fast sometimes. I live around the urban part of the city with my boyfriend, Elair. The sweetest thing, that man is... Ah! You were saying?"

>ask him about his job
"Oh, Walkers like myself are just people who go outside. Y'know, collect-slash-analyze moondust samples, scout for water ice, et cetera. Nerd stuff."

>ask him about the city
"You must not be from around these parts, huh?" He vaguely gestures with an open hand to everything.

"This is El Tellaga Tyne! Quite a mouthful, yes, I know. One of the older lunar cities, I think. It's been around for several hundred Earth years. And that's all I know, I'm no historian or anything."

>ask him where he got his clothes
I didn't understand that sentence.

>Ask him about where he got his clothes
"You like this outfit? I got all this for 60 credits at that thrift store down the road!" He cranes his neck in that general direction. "Looks like they're closed. Oh well. Hey, you should check it out sometime!"

>n
SURFACE

    *** You can't breathe ***

Would you like to RESTART, RESTORE a saved game, QUIT or UNDO the last command?

* * *

>x me
As good-looking as ever.

* * *

>x sink
A small white porcelain sink, attached to the wall. There are two knobs, one for hot water and one for cold. A mirror sits above the sink, also flush in the wall.

>x mirror
Specks of dust line the edges of the rectangular mirror. You see yourself, the opposite wall, and the

>x window
You see nothing special about window.

* * *

>x window
The city's edge. Only a few apartment buildings stand between where you are and the edge of the dome. There are hardly any lights here, aside from the streetlights on the road, leading to the city entrance.

Beyond it, to the south, lies the Badlands,